*************************************************************
*..      *           *        *  *           *  *  *        *
*..****  *  ****  *  *  *******  *  **********  *  *  ****  *
*..   *  *  *     *  *     *     *     *  *  *     *  *     *
*..*******  *************  *  ****  ****  *  ****  *  *  *  *
*.....*        *  *  *  *              *        *     *  *  *
****..*  *******  *  *  *  *******  ****  *******  **********
*  *.....   *                 *     *  *  *  *  *  *     *  *
*  ****..*  **********  *******  ****  *  *  *  *  *  ****  *
*  *.... *                    *     *     *     *  *        *
*  *..*******  *************  *******  ****  ****  *  ****  *
*  *..   *     *        *  *  *     *                 *     *
*  *..*  **********  ****  *  *  ****  ****  *  ****  *  *  *
*  *..*  *  *                       *  *     *  *  *  *  *  *
*  *..****  *******************************  *  *  ****  *  *
*.....*           *  *        *        *  *  *     *     *  *
*..**********  ****  ****  ****  *******  *  ****  ****  ****
* ..........         *        *        *     *        *     *
*******  *..*******  *  ****  *  *  ****  *******  *  *******
*  *     *........*  *  *        *  *  *     *     *        *
*  *  **********..*************  ****  ****  ****  **********
*           *  *..   *     *  *  *     *        *  *        *
*  ****  ****  *..*******  *  *  *  *  ****  **********  ****
*  *  *  *  *   ..*  *        *  *  *  *      ........*     *
****  *  *  ****..*  *******  *  ****  *******..****..*  *  *
*        *  *   ..*...........*.................*.... *  *  *
*  ****  *  ****..*..*  ****..*..*******  *  ****..*******  *
*  *           *.....*     *..*..   *     *     * .......   *
**********  **********  *  *..*..*******  *************..*  *
*     *  *  *  *        *  *.....*        *  *     *.... *  *
****  *  ****  **********  *  ****  *  *  *  ****  *..****  *
*              *  *     *  *  *     *  *           *..*  *  *
*******  *******  ****  *******************  ****  *..*  ****
*     *        *     *              *           *  *..      *
*  *  *  ****  ****  *  *  *  ****  ****  **********..****  *
*  *  *  *  *  *        *  *     *  *              *..*     *
*  *  *  *  **********  *************  *******  ****..*******
*  *                    *     *  *  *     *     *    ....*  *
****  **********  *******  ****  *  *  **********  ****..*  *
*           *                             *           *.....*
*************************************************************
