41 61
*************************************************************
*        *           *        *  *           *  *  *        *
*  ****  *  ****  *  *  *******  *  **********  *  *  ****  *
*     *  *  *     *  *     *     *     *  *  *     *  *     *
*  *******  *************  *  ****  ****  *  ****  *  *  *  *
*     *        *  *  *  *              *        *     *  *  *
****  *  *******  *  *  *  *******  ****  *******  **********
*  *        *                 *     *  *  *  *  *  *     *  *
*  ****  *  **********  *******  ****  *  *  *  *  *  ****  *
*  *     *                    *     *     *     *  *        *
*  *  *******  *************  *******  ****  ****  *  ****  *
*  *     *     *        *  *  *     *                 *     *
*  *  *  **********  ****  *  *  ****  ****  *  ****  *  *  *
*  *  *  *  *                       *  *     *  *  *  *  *  *
*  *  ****  *******************************  *  *  ****  *  *
*     *           *  *        *        *  *  *     *     *  *
*  **********  ****  ****  ****  *******  *  ****  ****  ****
*                    *        *        *     *        *     *
*******  *  *******  *  ****  *  *  ****  *******  *  *******
*  *     *        *  *  *        *  *  *     *     *        *
*  *  **********  *************  ****  ****  ****  **********
*           *  *     *     *  *  *     *        *  *        *
*  ****  ****  *  *******  *  *  *  *  ****  **********  ****
*  *  *  *  *     *  *        *  *  *  *              *     *
****  *  *  ****  *  *******  *  ****  *******  ****  *  *  *
*        *  *     *           *                 *     *  *  *
*  ****  *  ****  *  *  ****  *  *******  *  ****  *******  *
*  *           *     *     *  *     *     *     *           *
**********  **********  *  *  *  *******  *************  *  *
*     *  *  *  *        *  *     *        *  *     *     *  *
****  *  ****  **********  *  ****  *  *  *  ****  *  ****  *
*              *  *     *  *  *     *  *           *  *  *  *
*******  *******  ****  *******************  ****  *  *  ****
*     *        *     *              *           *  *        *
*  *  *  ****  ****  *  *  *  ****  ****  **********  ****  *
*  *  *  *  *  *        *  *     *  *              *  *     *
*  *  *  *  **********  *************  *******  ****  *******
*  *                    *     *  *  *     *     *        *  *
****  **********  *******  ****  *  *  **********  ****  *  *
*           *                             *           *     *
*************************************************************