21 25
*************************
* *     * *       *     *
* ****  * ******* ***** *
*     *                 *
*** **** * ** ****** ****
*        * *            *
* **** * *  ******* * * *
* *      *       *    * *
* ********** ******** ***
*    *          *       *
* **** * ****************
* *    *       *        *
* *************** * * * *
*    *              * * *
* ********** ******** * *
*               *   * * *
* *************** *** * *
*       *             * *
******  * ******* *******
*         *             *
*************************