*******************************************************************************************
*..   *        *           *        *     *                 *  *              *        *  *
*..*  ****  ****  ****************  ****  *  *************  *  *  *  *  *  *  *  *  *  *  *
*..*  *              *           *  * .......      *     *     *  *  *  *  *  *  *  *     *
*..*  *  *  ****  *  **********  *  *..****..****  ****  *  *************  *  *  ****  *  *
*..*     *  *     *  *  *  *         ..*  *..*  *  *  *        *           *     *  *  *  *
*..*******************  *  **********..*  *..*  ****  *******  *******  ****  ****  ****  *
*..*...........*                 *   .... *........   *     *  *     *     *     *        *
*..*..*******..*************  *  *******..*******..****  ****  ****  *  ****  **********  *
*.....*  *  *..............*  *   ........*     *..      *  *     *     *     *     *     *
*  ****  *  ****  *  ****..*******..****  *  *  *..*******  *  *  *  *  ****  ****  *******
*        *  *     *     *.....*  *..*  *  *  *   ........   *  *     *  *     *           *
****  *  *  *  *  *  *******..*  *..*  *  *  ****  ****..****  ****  *************  *******
*     *     *  *  *  *      ........   *  *     *  *  *..   *     *  *  *                 *
*  *************************  *  *  *  *******  ****  *..****  *  *  *  *  *******  *  ****
*  *        *  *           *  *  *  *  *     *  *  *  *.....*  *  *     *  *        *     *
*  *  *******  *  ****  *******  *******  *******  *  ****..*************  ****  ****  ****
*  *                 *  *  *     *     *   .....*  *....... *  *           *  *     *     *
*  *  ****  *******  *  *  *  ****  *******..*..*  *..*******  *******  *  *  *************
*        *  *        *  *        *         ..*........      *  *        *        *  *     *
****  *******  ****  *******  *******  *  *..*******  *******  ****************  *  *  ****
*        *     *        *        *  *  *  * ....*  *  *  *     *           *     *  *     *
**********  **********  *******  *  *  ****  *..*  ****  ****  ****  ****  ****  *  ****  *
*     *     *     *     *  *  *  *     *     *.....      *        *  *     *     *        *
*  *************  *******  *  ****  ****  *  ****..*******  ****  ****  ****  ****  ****  *
*           *        *     *     *  *     *  *   ..*  *     *           *  *  *     *     *
*  ****  *  *******  *  *  *  *  *  *  *  *******..*  ****  *  **********  *  *  ****  ****
*  *     *           *  *  *  *     *  *  *     *..   *     *     *  *     *  *  *     *  *
*******  *  *******  *  *******  *  *  ****  *  *..*************  *  ****  *  *  *******  *
*  *  *  *     *              *  *  *     *  *  *..*.....      *     *  *  *  *           *
*  *  *  ****  ****************  *******  *  ****..*..*..*******  ****  *  *  *  *******  *
*        *  *  *  *     *           *  *        *..*..*..*     *........            *     *
*  *  ****  ****  *  *******  ****  *  **********..*..*..****  *..****..**********  ****  *
*  *        *     *  *  *  *     *  *  *  *      .....*...........   *..*        *  *     *
*******  *  ****  *  *  *  ****  ****  *  *******  **********  *******..*  ****  **********
*  *     *     *           *     *           *     *                 *..      *           *
*  *  ****  ****  *  *  ****  *  ****  *************  *  *************..****  *************
*  *  *     *  *  *  *  *  *  *  *     *           *  *  *     *   .... *           *     *
*  ****  ****  *  *******  **********  *  ****  ****  *  ****  ****..*******  ****  *  ****
*     *  *     *                       *     *     *  *  *     *  *..*     *  *  *  *  *  *
****  *  *  **********  ****************  ****  *  *  ****  ****  *..****  ****  ****  *  *
*                    *     *                 *  *        *  *       .............   *     *
****************  ****  ****  ****  ****  *  *************  ****  *  *  *******..****  ****
*  *              *  *     *     *     *  *        *     *     *  *  *  *  *.... *  *     *
*  ****  **********  *  *******  *  *******************  *  *************  *..****  ****  *
*                          *     *     *              *     *  *     *  *    ....         *
*  *  *  *  *************  ****  *******  *  *  *******  *  *  *  *  *  *  ****..*******  *
*  *  *  *  *     *  *  *  *  *           *  *     *  *  *     *  *     *  *   ..*  *     *
*  ****  ****  ****  *  *  *  *  *  *  *******  *  *  *  *  *  *  *  *  ****  *..*  *******
*     *     *     *     *        *  *     *     *  *     *  *  *  *  *        *........*  *
****  *  *******  ****  ****  ****  ****  *******  ****  *  *  *  ****************  *..*  *
*     *  *        *              *     *        *  *     *  *  *           *     *  *.....*
*******  *  **********  ****  ****  ****  *  ****  ****  ****  *  *******  ****  *******..*
*  *  *  *           *     *     *     *  *  *  *  *     *           *  *        *     *..*
*  *  *******  *************  ****  **********  *******  ****  *  ****  *  ****  ****  *..*
*        *  *     *  *        *     *  *     *  *     *  *     *  *  *        *  *  *  *..*
*******  *  *  ****  ****  *******  *  *  ****  *  ****  ****  ****  *******  *  *  *  *..*
*     *     *  *  *           *     *  *  *  *  *  *     *  *              *  *  *      ..*
*  ****  ****  *  *  ****  *  ****  *  *  *  *  *  *  ****  *  **********  ****  *******..*
*                       *  *     *  *                    *           *        *  *      ..*
*******************************************************************************************
