*************************
*.*     * *       *     *
*.****  * ******* ***** *
*...  *                 *
***.**** * ** ****** ****
*...     * *            *
*.**** * *  ******* * * *
*.*      *       *    * *
*.********** ******** ***
*.   *          *       *
*.**** * ****************
*.*    *       *   ...  *
*.*************** *.*.* *
*.   *      ........*.* *
*.**********.********.* *
*............   *   *.* *
* *************** ***.* *
*       *        .....* *
******  * *******.*******
*         *      .......*
*************************
