61 91
*******************************************************************************************
*     *        *           *        *     *                 *  *              *        *  *
*  *  ****  ****  ****************  ****  *  *************  *  *  *  *  *  *  *  *  *  *  *
*  *  *              *           *  *              *     *     *  *  *  *  *  *  *  *     *
*  *  *  *  ****  *  **********  *  *  ****  ****  ****  *  *************  *  *  ****  *  *
*  *     *  *     *  *  *  *           *  *  *  *  *  *        *           *     *  *  *  *
*  *******************  *  **********  *  *  *  ****  *******  *******  ****  ****  ****  *
*  *           *                 *        *           *     *  *     *     *     *        *
*  *  *******  *************  *  *******  *******  ****  ****  ****  *  ****  **********  *
*     *  *  *              *  *           *     *        *  *     *     *     *     *     *
*  ****  *  ****  *  ****  *******  ****  *  *  *  *******  *  *  *  *  ****  ****  *******
*        *  *     *     *     *  *  *  *  *  *              *  *     *  *     *           *
****  *  *  *  *  *  *******  *  *  *  *  *  ****  ****  ****  ****  *************  *******
*     *     *  *  *  *                 *  *     *  *  *     *     *  *  *                 *
*  *************************  *  *  *  *******  ****  *  ****  *  *  *  *  *******  *  ****
*  *        *  *           *  *  *  *  *     *  *  *  *     *  *  *     *  *        *     *
*  *  *******  *  ****  *******  *******  *******  *  ****  *************  ****  ****  ****
*  *                 *  *  *     *     *        *  *        *  *           *  *     *     *
*  *  ****  *******  *  *  *  ****  *******  *  *  *  *******  *******  *  *  *************
*        *  *        *  *        *           *              *  *        *        *  *     *
****  *******  ****  *******  *******  *  *  *******  *******  ****************  *  *  ****
*        *     *        *        *  *  *  *     *  *  *  *     *           *     *  *     *
**********  **********  *******  *  *  ****  *  *  ****  ****  ****  ****  ****  *  ****  *
*     *     *     *     *  *  *  *     *     *           *        *  *     *     *        *
*  *************  *******  *  ****  ****  *  ****  *******  ****  ****  ****  ****  ****  *
*           *        *     *     *  *     *  *     *  *     *           *  *  *     *     *
*  ****  *  *******  *  *  *  *  *  *  *  *******  *  ****  *  **********  *  *  ****  ****
*  *     *           *  *  *  *     *  *  *     *     *     *     *  *     *  *  *     *  *
*******  *  *******  *  *******  *  *  ****  *  *  *************  *  ****  *  *  *******  *
*  *  *  *     *              *  *  *     *  *  *  *           *     *  *  *  *           *
*  *  *  ****  ****************  *******  *  ****  *  *  *******  ****  *  *  *  *******  *
*        *  *  *  *     *           *  *        *  *  *  *     *                    *     *
*  *  ****  ****  *  *******  ****  *  **********  *  *  ****  *  ****  **********  ****  *
*  *        *     *  *  *  *     *  *  *  *           *              *  *        *  *     *
*******  *  ****  *  *  *  ****  ****  *  *******  **********  *******  *  ****  **********
*  *     *     *           *     *           *     *                 *        *           *
*  *  ****  ****  *  *  ****  *  ****  *************  *  *************  ****  *************
*  *  *     *  *  *  *  *  *  *  *     *           *  *  *     *        *           *     *
*  ****  ****  *  *******  **********  *  ****  ****  *  ****  ****  *******  ****  *  ****
*     *  *     *                       *     *     *  *  *     *  *  *     *  *  *  *  *  *
****  *  *  **********  ****************  ****  *  *  ****  ****  *  ****  ****  ****  *  *
*                    *     *                 *  *        *  *                       *     *
****************  ****  ****  ****  ****  *  *************  ****  *  *  *******  ****  ****
*  *              *  *     *     *     *  *        *     *     *  *  *  *  *     *  *     *
*  ****  **********  *  *******  *  *******************  *  *************  *  ****  ****  *
*                          *     *     *              *     *  *     *  *                 *
*  *  *  *  *************  ****  *******  *  *  *******  *  *  *  *  *  *  ****  *******  *
*  *  *  *  *     *  *  *  *  *           *  *     *  *  *     *  *     *  *     *  *     *
*  ****  ****  ****  *  *  *  *  *  *  *******  *  *  *  *  *  *  *  *  ****  *  *  *******
*     *     *     *     *        *  *     *     *  *     *  *  *  *  *        *        *  *
****  *  *******  ****  ****  ****  ****  *******  ****  *  *  *  ****************  *  *  *
*     *  *        *              *     *        *  *     *  *  *           *     *  *     *
*******  *  **********  ****  ****  ****  *  ****  ****  ****  *  *******  ****  *******  *
*  *  *  *           *     *     *     *  *  *  *  *     *           *  *        *     *  *
*  *  *******  *************  ****  **********  *******  ****  *  ****  *  ****  ****  *  *
*        *  *     *  *        *     *  *     *  *     *  *     *  *  *        *  *  *  *  *
*******  *  *  ****  ****  *******  *  *  ****  *  ****  ****  ****  *******  *  *  *  *  *
*     *     *  *  *           *     *  *  *  *  *  *     *  *              *  *  *        *
*  ****  ****  *  *  ****  *  ****  *  *  *  *  *  *  ****  *  **********  ****  *******  *
*                       *  *     *  *                    *           *        *  *        *
*******************************************************************************************